#.#.........#...........#.......#.....#.#
#.#.#.#####.#####.#####.#.#####.###.#.#.#
#.#.#.....#.......#...#.#.....#.....#.#.#
#.#.#####.#.#######.#.#.#####.#######.#.#
#...#.#...#.#.....#.#.#.....#...#.....#.#
#.###.#.###.#.###.#.#.#####.###.#.#####.#
#.#...#.#...#...#.#.#.....#.#...#...#...#
#.###.#.#####.###.#######.#.#.#####.###.#
#.....#.#.....#...#.......#...#...#.....#
 ####.#.#.#####.###.###########.#######.#
#...#.#...#...#...#...#.............#...#
#.###.#####.#.###.#.#.#.#######.#.###.## 
#.....#...#.#.#.#.#.#.#.#.....#.#.......#
#.#####.#.#.#.#.#.#.#.#.#.###.#########.#
#...#...#.#.#...#.#.#...#.#.#.......#...#
 ##.###.#.#.###.#.#####.#.#.#######.#.## 
#...#...#...#...#.#...#.#...#.#...#.#...#
#.###.#########.#.#.#.#####.#.#.#.#.#### 
#...#.#.......#.#.#.#.....#.#...#.#.....#
 ##.#.#.#####.#.#.#.###.###.#####.#####.#
#.#.#.#.....#.#.#...#.#...#.#.......#.#.#
#.#.#.#####.#.#######.#.#.#.#.#####.#.#.#
#.#...#.#...#.....#...#.#.....#...#...#.#
#.###.#.#.#######.#.###########.#.#####.#
#.#...#.#.#.....#.#...........#.#.......#
#.#.###.#.#.###.#.###########.#.#######.#
#.#.#...#.#...#...........#...#.#.......#
#.#.#.###.###.#############.###.######## 
#.#.#...#...#.....#.......#...#.#...#...#
#.#.###.###.#####.#.#####.###.#.#.#.#.#.#
#.#.......#...#.#...#...#...#.#.#.#...#.#
#.#######.###.#.#######.###.#.#.#.#####.#
#.......#...#.....#.......#...#.#.#.Z.#.#
#.#####.#.#######.#.#.#########.#.###.#.#
#.....#...#.......#.#.......#.......#.#.#
 ####.#####.#############.#.#######.#.#.#
#...#...#...#...#.........#.#...#.....#.#
#.#.###.#.###.#.#.#########.#.#.#######.#
#.#.....#.....#...#...........#.........#
 # ##### ##### ### ########### ######### 